R 1500 1000
C 33,43,19
F 120,145,100

NO      ./murmoussu.xpm
SO ./murmoussu2.xpm
WE ./murmoussu3.xpm
EA ./murmoussu4.xpm
S   ./57.xpm

111111111111111111
12W000020000000021
100000020000000021
1000000200011111201
100000000001111001
10000000000000111
111111100010111111
 111100011111111111
 11111111111111111
